[#, #, #, #, #, #, #, #, #, #]
[#,  ,  ,  ,  ,  , #, #,  , #]
[#,  , #,  , #,  ,  ,  ,  , #]
[#,  , #,  , #, #, #, #, #, #]
[#, #, #,  , #,  ,  ,  ,  , O]
[B,  ,  ,  , #,  , #,  , #, #]
[#,  , #, #, #, #, #,  ,  , #]
[#,  , #,  ,  ,  , #, #,  , #]
[#,  ,  ,  , #,  ,  ,  ,  , #]
[#, #, #, #, #, #, #, #, #, #]
