##########
#     ## #
# # #    #
# # ######
### #    O
B   # # ##
# #####  #
# #   ## #
#   #    #
##########